"filename", "language", "Rust", "TOML", "Shell Script", "JSON with Comments", "comment", "blank", "total"
"/Users/ehuff/Documents/VsCodeProjects/TcpTest/stealthstream/Cargo.lock", "TOML", 0, 1319, 0, 0, 2, 166, 1487
"/Users/ehuff/Documents/VsCodeProjects/TcpTest/stealthstream/Cargo.toml", "TOML", 0, 53, 0, 0, 3, 13, 69
"/Users/ehuff/Documents/VsCodeProjects/TcpTest/stealthstream/StealthStream.code-workspace", "JSON with Comments", 0, 0, 0, 20, 0, 0, 20
"/Users/ehuff/Documents/VsCodeProjects/TcpTest/stealthstream/benches/tungstenite_vs_stealthstream.rs", "Rust", 147, 0, 0, 0, 5, 29, 181
"/Users/ehuff/Documents/VsCodeProjects/TcpTest/stealthstream/build.sh", "Shell Script", 0, 0, 1, 0, 0, 0, 1
"/Users/ehuff/Documents/VsCodeProjects/TcpTest/stealthstream/examples/client/Cargo.lock", "TOML", 0, 548, 0, 0, 2, 73, 623
"/Users/ehuff/Documents/VsCodeProjects/TcpTest/stealthstream/examples/client/Cargo.toml", "TOML", 0, 9, 0, 0, 1, 3, 13
"/Users/ehuff/Documents/VsCodeProjects/TcpTest/stealthstream/examples/client/src/main.rs", "Rust", 24, 0, 0, 0, 1, 7, 32
"/Users/ehuff/Documents/VsCodeProjects/TcpTest/stealthstream/examples/server/Cargo.toml", "TOML", 0, 9, 0, 0, 1, 3, 13
"/Users/ehuff/Documents/VsCodeProjects/TcpTest/stealthstream/examples/server/build.sh", "Shell Script", 0, 0, 3, 0, 0, 0, 3
"/Users/ehuff/Documents/VsCodeProjects/TcpTest/stealthstream/examples/server/src/main.rs", "Rust", 38, 0, 0, 0, 0, 7, 45
"/Users/ehuff/Documents/VsCodeProjects/TcpTest/stealthstream/rustfmt.toml", "TOML", 0, 15, 0, 0, 0, 1, 16
"/Users/ehuff/Documents/VsCodeProjects/TcpTest/stealthstream/src/client/builder.rs", "Rust", 61, 0, 0, 0, 26, 15, 102
"/Users/ehuff/Documents/VsCodeProjects/TcpTest/stealthstream/src/client/client_struct.rs", "Rust", 388, 0, 0, 0, 66, 77, 531
"/Users/ehuff/Documents/VsCodeProjects/TcpTest/stealthstream/src/client/mod.rs", "Rust", 4, 0, 0, 0, 0, 2, 6
"/Users/ehuff/Documents/VsCodeProjects/TcpTest/stealthstream/src/errors.rs", "Rust", 36, 0, 0, 0, 1, 6, 43
"/Users/ehuff/Documents/VsCodeProjects/TcpTest/stealthstream/src/lib.rs", "Rust", 12, 0, 0, 0, 0, 4, 16
"/Users/ehuff/Documents/VsCodeProjects/TcpTest/stealthstream/src/protocol/constants.rs", "Rust", 20, 0, 0, 0, 14, 5, 39
"/Users/ehuff/Documents/VsCodeProjects/TcpTest/stealthstream/src/protocol/framing.rs", "Rust", 153, 0, 0, 0, 47, 25, 225
"/Users/ehuff/Documents/VsCodeProjects/TcpTest/stealthstream/src/protocol/handshake.rs", "Rust", 89, 0, 0, 0, 6, 16, 111
"/Users/ehuff/Documents/VsCodeProjects/TcpTest/stealthstream/src/protocol/messaging.rs", "Rust", 242, 0, 0, 0, 13, 40, 295
"/Users/ehuff/Documents/VsCodeProjects/TcpTest/stealthstream/src/protocol/mod.rs", "Rust", 9, 0, 0, 0, 0, 2, 11
"/Users/ehuff/Documents/VsCodeProjects/TcpTest/stealthstream/src/protocol/packet.rs", "Rust", 345, 0, 0, 0, 19, 60, 424
"/Users/ehuff/Documents/VsCodeProjects/TcpTest/stealthstream/src/protocol/stream.rs", "Rust", 101, 0, 0, 0, 16, 15, 132
"/Users/ehuff/Documents/VsCodeProjects/TcpTest/stealthstream/src/protocol/tls.rs", "Rust", 16, 0, 0, 0, 6, 3, 25
"/Users/ehuff/Documents/VsCodeProjects/TcpTest/stealthstream/src/server/builder.rs", "Rust", 124, 0, 0, 0, 18, 20, 162
"/Users/ehuff/Documents/VsCodeProjects/TcpTest/stealthstream/src/server/mod.rs", "Rust", 16, 0, 0, 0, 2, 7, 25
"/Users/ehuff/Documents/VsCodeProjects/TcpTest/stealthstream/src/server/server_struct.rs", "Rust", 258, 0, 0, 0, 26, 41, 325
"Total", "-", 2083, 1953, 4, 20, 275, 640, 4975